##############
#............#
#....N.......#
#............#
#............#
#............>
#............#
#............#
##############
