################
#~~~...........#
#~~~~.....N....#
>....~~~.......#
#..~~~~~~~.....#
#..~~~I~~~.....#
#..~~~~~~~.....#
#....~~~.......#
#..............#
#..............#
################
