#########################
#.......................#
>............N..........>
#.......................#
#........~~~~...........#
#.......................#
#########################
